¿Qué tipo de pastel es este?	What kind of socket is this?
¿Cómo consigues que un niño coma?	How do you teach a toddler not to share?
¿Necesito un visado de tránsito en el Reino Unido para volar a las Islas Canarias?	Is there a way to find out if I need a transit visa for a layover in the UK?
¿Qué signos indican una buena calidad de agua para peces tropicales?	Besides water quality, what should I consider before adding more tropical fish?
¿Cómo puedo hacer que mis compañeros dejen de interrumpirme?	How can I stop my pie from burning?
¿Qué es un arrendador del mezrag?	What exactly is a CV?
¿Cómo puedo limpiar mi máquina de hacer pasta?	How do I clean a very dirty refrigerator?
¿Cómo elimino la celulitis?	How to get rid of oversleeping?
¿De dónde podría estar saliendo el aire en el sistema hidráulico?	Where could the water leaching from the base of the drywall be coming from?
¿Cuál es la diferencia entre un amplificador y un cabezal?	What is the difference between an electronic and a magnetic ballast?
¿Cómo puedo evitar quedarme dormido?	How to get rid of unwanted and annoying co-author?
¿Cómo elimino la pintura de un suelo de madera?	How do I remove paint from a porous table top?
¿Cómo evito que mi perro ladre constantemente cuando no estoy en casa?	How can I keep my dog from barking when I don't know what he's barking at?
¿Cómo evitar pagar impuestos más altos si trabajo como autónomo en el Reino Unido?	How do I avoid paying income taxes on the sale of my business abroad?
¿Qué puedo hacer para ponerme en forma mientras estoy en el coche?	What can I do to make my writing fit the 1950s?
¿Cómo reparo suelos de madera dañados por la humedad?	How do I repair spots of damaged hardwood floor finish?
¿Debo aplicar para obtener una visa de tránsito del Reino Unido si tengo una visa de visitante?	Do I need to apply for a visa to enter to South Korea if I already got Aus visa?
¿Cuáles son las ventajas y los inconvenientes de amamantar a un bebé cuando lo pide?	What are the pros and cons of being co-supervised?
¿Es normal que un gatito tenga una barriga grande?	Is it normal for a 12-year-old to have Vibrato?
¿Hay alguna diferencia entre condimentar y aromatizar?	What is the difference between a stock and a bond?
¿Qué debería buscar en una clase de cocina?	What should I look for in a jump rope?
¿Cuál es la forma más barata de viajar de Polonia a Lyon (Francia)?	What is the cheapest way to send books from USA to France?
¿Cómo relleno un hueco entre mi chimenea y el marco de madera alrededor?	How do I fix a hole/gap between my shower tile and the dry wall next to it?
¿Es «plausible» un falso amigo del inglés al español?	What's the difference between a "false cognate" and a "false friend"?
¿Cómo puedo hacerlo para aplicar para 2 trabajos más cuando ya tengo un trabajo a tiempo parcial?	How can I put my resume online when I already have a job?
¿Qué puedo hacer siendo realista para aumentar mi capacidad crediticia?	What more can I do to improve my credit score?
La esposa de un ciudadano británico con residencia permanente en el Reino Unido, ¿necesita una visa Schengen para viajar a Francia?	Does a UK Citizen with a foreign passport need a Visa to enter the UK?
¿Qué significa «a» en la cláusula de bienestar general?	What does the term "Out of the Furnace" refer to?
¿Necesito un visado de tránsito del Reino Unido al volar desde Líbano a Irlanda?	Do I need UK transit visa to going to Ireland?
¿Cuál es el mejor método para limpiar un rallador?	What is the best way to store fresh berries?
¿En qué países es posible entrar en un programa de doctorado en ciencias de la vida, tras una licenciatura?	Is it possible to do a Master's in Mathematics after a Bachelor's in Economics?
¿Cuál es la mejor forma de sazonar comidas preparadas en sartén de hierro fundido?	What's the best way to store asparagus?
¿Cuál es la diferencia entre unas acciones y un bono?	What is the difference between chicken cubes and ground chicken?
¿Cómo puedo escribir el monólogo interior de un personaje?	In a dialogue, how do you write that a character says a letter?
¿Cómo consigo que un reclutador deje de molestarme?	How do I get a coworker to stop chit chatting?
¿Qué significado tiene el gato?	What is the meaning of the butterfly?
¿Necesito un visado para entrar en los Estados Unidos como ciudadano del Reino Unido en tránsito?	Does a UK Citizen with a foreign passport need a Visa to enter the UK?
¿Es posible criar grillos?	Is it possible to patent recipes?
¿Cómo puedo distinguir a un conejo de un gato?	How can I test a rabbit's vision?
¿Cómo elimino la pintura de un suelo de madera?	How can I remove paint from slotted screw heads?
¿Cómo reparo los desconchones en las ventanas de madera?	How can I repair my floors' finish?
¿Tienes coche?	Do you have a title?
¿Cómo conecto el cableado del extractor de aire de un baño y de la iluminación en dos interruptores?	How do I wire a combo with two supplies?
¿Qué tipo de telaraña es ésta, y cómo puedo librarme de ella?	What are these bugs and how do I get rid of them?
¿Qué clase de aislamiento es?	What kind of form is it?
¿Cómo reparo un heuco entre la bañera y la pared?	How do I fix a hole/gap between my shower tile and the dry wall next to it?
¿Cómo fortalezco mis muñecas?	How to strengthen calf muscles?
¿Cuál es la diferencia entre unas acciones y un bono?	Is there a difference between a manual and an automatic grinder?
¿Cuáles son las ventajas e inconvenientes de los distintos tipos de conmutadores inteligentes en el mercado británico?	What are the types of Guitar available and what are the pros and cons of each?
¿Necesito un visado de tránsito para volar desde Alemania a India, con escala en Londres?	Do I need a UK transit visa when flying from Lebanon to Ireland?
¿Qué es una hoja de vida?	What exactly is a CV?
¿Cuál es el término para el aperitivo que se toma al final de la comida?	What is the proper term for the "year 0"?
¿Cuál es el significado de la escena con el policía cerca del final de "El Artista"?	What is the meaning of the apearance of dogs in the good the bad the ugly?
¿Cómo se dice "Necesito acciones de la empresa o me busco un nuevo trabajo"?	Can I say "No" politely for a task I'm not interested in doing?
¿Necesito un visado de tránsito del Reino Unido al volar desde Líbano a Irlanda?	Do I need a visa to transit India?
¿Cómo pinto una obra de arte en una pared?	How do I clean a Hammerite paint brush?
¿Cómo puedo eliminar lechada y mortero de un desagüe?	How can I fix a very slow drain?
¿Cómo puedo distinguir a un conejo de un gato?	How can I tell the difference between play and aggression at the dog park?
¿Cómo puedo sacar un tornillo realmente atascado?	How can I remove paint from slotted screw heads?
¿Necesito un visado de tránsito para Londres?	Do I need to apply for a UK transit visa when I have a visitor visa?
Sólo tienes que basar tu respuesta en lo que sabes, que es lo que deseas.	rmkilc, what you want to do in principle is FINE.
Podría probar con algo como una Philips SpotOn.	You could try something like chicken thighs.
Esto debería ser de utilidad, no es precisamente exacto, pero probablemente puedas averiguarlo a partir de aquí.	I can tell you where it comes from, but not why it's the way it is.
No es tu dinero.	It's not too unusual.
Sólo tienes que basar tu respuesta en lo que sabes, que es lo que deseas.	I don't know what is better, but I think it depends on where you want to publish.
A veces si realmente lo deseas podrías tener que pagar a una agencia para conseguirte el sitio.	If you can not find the problem, you really need to call in an electrician.
En el primer caso, no creo que lo necesites	So I don't think you need to put it on the cover.
Es algo común en un calentador de agua.	Volcanic water is not a problem.
Tuve el mismo problema que tú.	I had the same issue.
Como puede ver en este sencillo ejemplo, hay mucha información.	This recipe just has a lot of liquid in you can see her dressing is very fluid.
La verdad es que no importa.	Maybe it doesn't.
Nunca lo uso.	I never worry about this.
No hace falta que lo sepas todo.	They really don't need to know.
En el primer caso, no creo que lo necesites	If you don't mind the extra weight, I would say definitely go for it.
Pensaré la respuesta que desconocemos.	I think, the answer is yet: We don't know.
Debes averiguar qué es lo que te funciona a ti.	You have to decide what you want to get out of this.
No creo que haya ninguna diferencia apreciable.	I don't think there's any reason other than historical chance.
No creo que haya ninguna otra razón aparte de la oportunidad histórica.	I don't think that there's any.
No hay una respuesta correcta.	There is no maximum.
Mira estos:	just take a look at the tail..!
La regla - ¡En caso de duda, deséchalo!	I always go by the rule "When in doubt, throw it out!
Si este es el caso, de verdad que no tienes que preocuparte tanto por el bistec.	In the first case, I think you don't need it.
Depende de cómo lo expreses.	It depends on how it's used.
Creo que deberías hacer ambos.	You should do it.
Si no sabes, contrata un electricista.	You don't have to know.
Creo que sí.	I don't think you should.
No creo que haya una sola definición.	I think there isn't a general answer.
Esto es lo que creo que deberías hacer.	I think you should do both.
No hay nada malo en vestir de manera formal.	There is nothing new in what you describe.
Tuve el mismo problema que tú.	I had the same problem.
Por lo que recuerdo, eso no pasaba en el libro.	Maybe everyone knew about this, and she was the only one who didn’t.
Esto no es una buena idea.	This would be a bad idea.
No intentaré describirlo, pero esto es lo que haré al respecto:	Although it's possible to do what you're asking I wouldn't recommend it.
Hay varias cosas que puedes hacer:	There are a few things you need to consider:
La verdad es que no importa.	So actually it didn't matter.
Creo que lo que buscas es un billete que te lleve en un viaje de vuelta al mundo	I believe the name of the movie you are looking for is Poltergeist 3.
Cuánto más lo harás, más rápido serás.	The more you sweat, the faster you will burn calories and fat.
Así que no creo que tengas que ponerlo en la portada.	I don't think you can validate the ticket on the train itself.
Dí siempre que tienes algo que declarar.	You will have absolutely no issues.
Tienes que leer mucho para saber lo que te gusta y lo que no.	You may have to experiment and find what you like.
Depende de cómo lo expreses.	It rather depends on which country you're in.
Es algo común en un calentador de agua.	This is not a good idea.
Mi consejo es no decir nada y hacerlo lo mejor que puedas.	The best thing you can do is to know your stuff.
Tienes razón sobre la definición tipo.	You are on the right path.
Siempre hay cosas que hacer, aunque pienses que no.	Yes, there is a reason to not do what you propose.
Creo que lo que puedes hacer en primer lugar es planificar apropiadamente tus prácticas.	The best thing you can do is to know your stuff.
Si no tienes uno no pasa nada, nadie esperaría que hubieses escrito mucho.	Sure you can have one, no one is going to arrest you for putting it in.
Depende en gran medida de la beca de la que se trate.	It depends on the fine print.
Por desgracia la respuesta a tu pregunta es que, sencillamente, no lo sabemos.	The answer to your question is not really.
Has dado en el clave.	You are on the right path.
Depende de cuál sea tu objetivo	It depends on what they are.
Tienes que leer mucho para saber lo que te gusta y lo que no.	It sounds like you don't know what you are doing with regards to electricity.
Tal vez lo desees, pero debes trabajar ajustándote al proceso que se te ha dado.	You just have to base your answer on what you do know, which is what you want.
), pero no lo es.	But it is not a good idea.
No veo que haya nada malo.	I don't think that there's any.
No creo que haya nada de verdad en lo que dices.	I don't think that there's any.
Sólo tienes que basar tu respuesta en lo que sabes, que es lo que deseas.	You have not quite mentioned what kind of work you would want to do.
La respuesta depende de dónde estés.	It depends on what they are.
Si se está interponiendo entre tú y tu trabajo deberías entonces comentárselo a tu jefe.	If you like the work, the people and how much your bringing home then stick with it.
En el primer caso, no creo que lo necesites	I think you don't have many rights in this case.
Resuelve estos problemas de manera óptima utilizando este proceso de tres pasos de manera recursiva.	In a word, we can solve a problem with optimal substructure using a three-step process.
El modelo de espacios vectoriales es uno de estos métodos, y se trata de un modelo algebraico.	The vector space model has the following limitations: 1.
La mayoría de estos idiomas proporciona un teclado «extendido», el cual se utiliza para subdividir otro.	However an object cannot be cast to a class which is no relative of it.
P(B|A) es la probabilidad condicionada de B dado A.	P(A) is the prior probability A.
El teorema de Bayes es una teorema sobre teoría de probabilidad formulado originalmente por el reverendo Thomas Bayes.	As a formal theorem, Bayes' theorem is valid in all common interpretations of probability.
Como un teorema oficial, el teorema de Bayes es válido en todas las interpretaciones universales de probabilidad.	Bayes' theorem is useful in evaluating the result of drug tests.
* P (A|B) es la probabilidad condicional de A, dado B.	P(A) is the probability of the student being a girl (which is 2/5).
En el modelo de espacio vectorial un documento es representado como un vector.	In vector space model, the documents from which the information is to be retrieved are represented as vectors.
Conjuntos de hipótesis y hechos del teorema de Bayes.	Bayes' theorem relates the conditional and marginal probabilities of two random events.
Joe registra todos sus resultados y alrededor de un 0,5% de las veces accidentalmente registra resultados erróneos.	Lucky Joe likes to predict the colour of the ball he selects and he is 80% accurate.
Si un término aparece en el documento, el valor del término en el vector es distinto de cero.	Vector space representation results in the loss of the order which the terms are in the document.
El teorema de Bayes toma el nombre de Thomas Bayes y es un método usado en la teoría de la probabilidad.	As an official theorem, Bayes' theorem is valid in all universal interpretations of probability.
Un modelo de espacio vectorial es un modelo algebraico para representar documentos de texto como vectores de identificadores.	The vector space model are the documents which are represented as “bags of words”.
La programación orientada a objetos es un tipo de programación que soporta encapsulación, sucesiones y polimorfismo.	In object oriented programming inheritance is also dependant on access level modifiers.
Cuanto más abajo estés en la línea de sucesión, más específicas se vuelven las clases.	If the term doesn’t occur within the document, the value in the vector is zero.
P(B) es la probabilidad a priori o marginal de B, y sirve para normalizar la probabilidad.	P(B|A) is the conditional probability of B given A.
Definir de forma recursiva el valor de una solución óptima 3.	Secondly to define the value of the optimal solution recursively.
Un documento se puede representar como un vector.	A document is represented as a vector and each dimension corresponds to a separate term.
No tienen que estar escritos en el idioma de los ordenadores.	This means that inheritance is used when types have common factors and these would be put into the superclass.
El valor de un vector es distinto de cero si un término ocurre en el documento.	If a term occurs in the document, its value in the vector is non-zero.
Si un término aparece en el documento, el valor vectorial será no nulo.	If a term appears in the document then its value in the vector is non-zero.
Al ser un teorema formal, el teorema de Bayes se cumple en todas las interpretaciones comunes de la probabilidad.	As an official theorem, Bayes' theorem is valid in all universal interpretations of probability.
de las páginas que proporcionan los enlaces.	The PageRank depends on the PageRank rating and number of all pages that have links to it.
Uno de los esquemas más conocidos es tf-idf (véase el ejemplo de abajo).	One of the most popular schemes is tf-idf weighting.
La programación dinámica se utiliza, por lo general, en problemas de optimización, donde se necesita encontrar la solución más eficiente.	Then, using this, the best overall path can be found, thereby demonstrating the dynamic programming principle.
P(A) es la probabilidad de que el estudiante sea una niña (que es 2/5).	P(B) is the prior or marginal probability of B, and acts to normalise the probability.
• P(A|B) es la probabilidad condicional de A, dado B.	P(B) is the prior or marginal probability of B, and acts to normalise the probability.
El concepto de la herencia consiste en reutilizar el código existente, con poca o ninguna modificación.	The peropos of inheritance in object oriented programming is to minimize the reuse of existing code without modification.
Frecuencia del término: esta fórmula cuenta cuántas veces el término ocurre en un documento.	If a term occurs in the document, its value in the vector is non-zero.
Se utilizó por primera vez en el Sistema de Recuperación de Información SMART.	Its first application was in the SMART Information Retrieval System.
Entonces, usando esto, se puede encontrar el mejor camino, con lo cual se demuestra el principio de la programación dinámica.	The further down an inheritance tree you get, the more specific the classes become.
Su primer uso fue en el Sistema de recuperación de Información SMART.	The similarity measures largely identify the retrieval efficiency of a particular information retrieval system.
La programación dinámica reduce el tiempo de cómputo, al solucionar subproblemas de forma ascendente.	Dynamic Programming solves problems by combining the solutions of subproblems.
Por tanto, el "programa" es el plan de acción óptimo que se está produciendo.	The "program" is the optimal plan for action that is produced.
La herencia es un concepto básico en la programación orientada a objetos.	Inheritance is one of the basic concepts of Object Oriented Programming.
de las páginas que proporcionan los enlaces.	The second method is the use of links.
Por último, el orden en el que aparecen los términos en el documento se pierde en la representación de espacio vectorial.	In the vector space model a document is represented as a vector.
Un documento se representa como un vector y cada dimensión corresponde a un término independiente.	Each dimensions corresponds to a separate terms.
Se usa para calcular probabilidades posteriores dadas unas observaciones determinadas.	It is usually used to calculate posterior probabilities given observations.
Normalmente, un término es una sola palabra, una palabra clave o una frase más larga.	A normal term is usually a single word, keywords or longer phrases.
La clave de la Programación Dinámica es encontrar la estructura de las soluciones óptimas.	This is highly used in dynamic programming.
La programación dinámica se utiliza, por lo general, en problemas de optimización, donde se necesita encontrar la solución más eficiente.	This is highly used in dynamic programming.
En su lugar, se crea un nuevo elemento que heredará las características de los que ya existan.	Inheritance in object oriented programming is a way to form new classes using classes that have already been defined.
El teorema de Bayes es una teorema sobre teoría de probabilidad formulado originalmente por el reverendo Thomas Bayes.	In probability theory, the prior and conditional probabilities of two random events are related by Bayes' theorem.
Sin embargo, la clave en Programación Dinámica es determinar la estructura de las soluciones óptimas.	The key to Dynamic Programming is to find the structure of optimal solutions.
Caso ignorado, extraer todas las palabras únicas del conjunto total de documentos.	Terms are basically the words or any indexing unit used to identify the contents of a text.
En la teoría de la probabilidad, las probabilidades anterior y condicional de dos eventos cualquiera están relacionadas con el teorema de Bayes.	Bayes' theorem relates the conditional and marginal probabilities of two random events.
En informática; la programación dinámica es una manera de resolver problemas que consiste en superponer subproblemas y subestructura óptima.	Dynamic Programming solves problems by combining the solutions of subproblems.
La cantidad de palabras únicas en el vocabulario define la dimensionalidad, si las palabras se usan para hacer referencia al término.	Ignoring case, extract all unique words from the entire set of documents.
Los matemáticos utilizan la palabra para describir un conjunto de reglas que cualquiera puede seguir para resolver un problema.	The word Programming in the name has nothing to do with writing computer programs.
El modelo de espacio vectorial tiene numerosas desventajas.	LIMITATION: There is some limitation of vector space model.
Dado que busca todas las posibilidades, es también muy preciso.	It doesn't take into account any information about B, so it is "prior".
Es similar al divide y vencerás, pero se diferencia en que sus subproblemas no son independientes.	This means that inheritance is used when types have common factors and these would be put into the superclass.
Un término que se presenta en el documento tiene un valor en el vector distinto a cero.	If a term appears in the document then its value in the vector is non-zero.
Uno de los métodos mejor conocidos se llama medición tf-idf.	One of the best known schemes is tf-idf weighting, proposed by Salton, Wong and Yang.
Se puede abusar del método si la gente enlaza deliberadamente a las webs con el fin de aumentar el PageRank de una web.	A dampening factor is used to counter random surfers, who get bored and then switch to other pages.
Dependiendo de la aplicación, la definición de término varía.	The way that a 'term' is defined depends on the application.
Si un término aparece en el documento, el valor del término en el vector es distinto de cero.	The order in which terms appear in the document is lost in a vector space representation.
Este método es mucho más eficiente recalculando y por lo tanto reduce el cómputo considerablemente.	This is a much quicker method than other more naive methods.
Se utiliza a menudo para calcular probabilidades a futuro en base a las observaciones presentes.	One of its uses is calculating posterior probabilities given observations.
Los pensadores y activistas a quien el Sr. Bowen entrevistas tienden a estar en contradicción con sus homólogos salafistas — defensores del Islam sunita purista asociados con Arabia Saudí — que hoy en día tienen una pequeña pero influyente presencia entre los musulmanes de Europa.	The thinkers and activists whom Mr Bowen interviews tend to be at odds with their Salafi counterparts—advocates of the purist Sunni Islam associated with Saudi Arabia—who nowadays have a small but influential presence among Europe’s Muslims.
Cuba tiene una incipiente comunidad blog, liderada por la comentarista popular Yoani Sánchez, que a menudo escribe sobre cómo ella y su marido son perseguidos y acosados por agentes del gobierno.	Cuba has a fledging blogging community, led by the popular commentator Yoani Sánchez, who often writes about how she and her husband are followed and harassed by government agents.
El ODS se retira a petición del Primer Ministro	ODS stands down at the request of the Prime Minister
Así que ahora los tres comisarios nos están atacando y diciendo que nos van a dar lo mejor de ella, mientras que la oferta que presentó fue precisamente lo que ellos querían.	So now all three commissioners are attacking us and saying that we're getting the best out of it, while the offer we put forward was just what they themselves wanted.
Unos lloraban abiertamente, otros rezaban, y las familias y amigos sostenían unos a otros en el aire frío.	Individuals openly wept, others prayed, and families and friends held each other in the frigid air.
La vida de los pacientes se puede prolongar notablemente gracias a una mezcla de medicamentos que evita que el virus del VIH se multiplique en el cuerpo.	Patients' lives can be greatly prolonged by a mixture of drugs which prevent the HIV virus from multiplying in the body.
Nos quedan las últimas plazas para Nochevieja y Navidad.	We have the last few vacancies for New Year's Eve and Christmas.
Iraq finalmente abrió sus puertas después de seis años de guerra y, en lugar de las empresas estadounidenses, tiene usted los asiáticos y europeos a la cabeza, dijo Ruba Husari, editor del Foro de Petróleo de Irak, una noticia en línea de salida.	Iraq finally opened its doors after six years of war, and instead of U.S. companies, you have Asians and Europeans leading the way, said Ruba Husari, the editor of Iraq Oil Forum, an online news outlet.
Los cargos concretos no se han hecho públicos, aunque según la ley cubana, un ciudadano cubano o un visitante extranjero pueden ser detenidos por casi cualquier cosa acusándolos de "peligrosidad".	The specific charges have not been made public, though under Cuban law, a Cuban citizen or a foreign visitor can be arrested for nearly anything under the claim of "dangerousness."
Este año, el coste de los ferrocarriles regionales han sido 200 millones más	This year's cost of regional railways: 200 million more
Todos los comunicados clave vendrán después de las elecciones, gane quien gane, añadió Roger Bootle, asesor financiero de Deloitte.	The all important announcements will come after the election, whoever wins it, added Roger Bootle, economic adviser to accountants Deloitte.
Jančura afirma que su crítica al transporte ferroviario regional ya le ha llevado a recibir amenazas de un miembro de la ČSSD.	Jančura claims that his criticism of regional rail transport has already led to his being threatened by a member of the ČSSD.
Para él y los demás marines que hicieron el viaje desde Camp Johnson en Jacksonville, Carolina del Norte, hasta el cementerio Nacional de Arlington para adornar tumbas, el día estaba dedicado a rendir homenaje a los hombres y mujeres que una vez estuvieron en su piel.	For him, and the other Marines who took the trip from Camp Johnson in Jacksonville, N.C. to Arlington National Cemetery to decorate graves, the day was about paying tribute to men and women who once stood in their shoes.
Entonces se trataría de una repentina escasez de vacantes, "estimaciones Jandura.	Then there'll be a sudden shortage of vacancies," estimates Jandura.
El almirante Nelson del encuentro como osados 14 años luchando midshipman sólo con el blanco de su aromática es sin duda un mito, pero otros son ciertas.	Admiral Nelson’s encounter as a plucky 14-year-old midshipman fighting only with the butt of his musket is surely a myth, but others are true.
La proteasa del VIH es la proteína que es esencial para el ciclo de vida del virus.	The HIV protease is the protein of the HIV virus, which is essential to the life-cycle of the virus.
Este año, los trenes regionales cuestan 200 millones más.	This year, regional trains are costing 200 million more.
El ministro del Tesoro Stephen Timms niega las subidas de impuestos y recortes de gastos esbozado fueron "una gota en el océano" en comparación con lo que se necesitaba.	Treasury minister Stephen Timms denied the tax rises and spending cuts outlined were a "drop in the ocean" compared to what was needed.
El presupuesto también ha sido criticado por Klaus.	The budget has also been criticised by Klaus.
Para él, y el otro Marines que tuvo el viaje de Camp Johnson en Jacksonville, N.C. cementerio Nacional de Arlington para decorar tumbas, el día trataba de rendir homenaje a los hombres y mujeres que una vez que se mantuvo en sus zapatos.	For him, and the other Marines who took the trip from Camp Johnson in Jacksonville, N.C. to Arlington National Cemetery to decorate graves, the day was about paying tribute to men and women who once stood in their shoes.
Brighton es un lugar muy emocionante y fantásticamente creativo y lo estamos tratando de probar y representar a través de la espiritualidad".	Brighton is such a fantastically creative and vibrant place and we are trying to try and represent that through spirituality."
La única amenaza fue que si no detenemos esto, podríamos perder nuestra licencia de servicio de autobús.	The only threat was that if we don't stop this, we could lose our bus licence.
En la República Checa, las sociedad por acciones Čeps es el operador exclusivo del sistema de transporte de energía eléctrica (líneas de alta tensión 220/400 kV)	In the Czech Republic, the joint stock company Čeps is the exclusive operator of transmission systems and 400 kV and 220 kV power lines.
Consiguió que Europa le prometa otros cinco mil, aunque en un principio había contado con diez.	He managed to squeeze a promise out of Europe for another 5 thousand, even though he himself was originally counting on 10.
Irónicamente es en las aguas hacia el norte de las dos naciones de caza que el hielo durará más larga.	Ironically it is in the waters towards the north of those two hunting nations that the ice will last longest.
Los padres pagaron 1600 coronas o más por la vacunación.	Parents paid 1600 crowns or more per vaccination.
Afirma que el déficit es demasiado alto, lo que empeora la crisis de financiación pública.	He claims the deficit is too high, which is worsening the public funding crisis.
En teoría, los tres principales partidos políticos apoyan incondicionalmente esta visión.	In theory, the three main political parties buy into this vision.
La situación en la planta empeorado bruscamente el pasado miércoles cuando unos 400 trabajadores espontánea celebró una huelga para protestar contra los incesantes las horas extraordinarias.	The situation at the plant deteriorated sharply last Wednesday when some 400 workers held a spontaneous strike to protest against the incessant overtime.
VMware está trabajando ahora con los operadores europeos y estadounidenses para poner a prueba smartphone virtualisation y las series debería llegar a los clientes en algún momento en 2012.	VMware is now working with European and American operators to test smartphone virtualisation and the sets should reach customers sometime during 2012.
Según Jančura esto es ilegal y va en contra de los principios del Tribunal Europeo de Justicia.	According to Jančura this is illegal and in contravention of the principles of the European Court of Justice.
Un equipo de científicos alemanes y checos han estado probando un nuevo compuesto que pueden frenar la propagación del VIH en el organismo.	A team of Czech and German scientists has been testing a new compound which can slow the spread of the HIV virus in the body.
Ahora está bajo arresto y se enfrenta a una pena de hasta tres años de prisión.	He is now under arrest and faces up to three years in prison.
En un día en el que poco ocurrió en las charlas sobre el clima patrocinadas por la ONU, miles de activistas recorrieron toda la ciudad llevando pancartas en inglés que decían "No hay un planeta B" y una en español que decía, "La Tierra dice, 'Basta'."	On a day when little happened in the U.N.-sponsored climate talks, thousands of activists walked across the city holding banners in English saying "There is No Planet B" and one in Spanish declaring, "The Earth is Saying, 'Enough.'
Barack Obama se convierte en el cuarto presidente estadounidense que recibe el Premio Nobel de la Paz	Barack Obama becomes the fourth American president to receive the Nobel Peace Prize
La Cámara dio dinero extra para los salarios de los empleados públicos para los servicios sociales, y para los pagos directos a los agricultores.	The House gave extra money for the salaries of state employees, for social services, and for direct payments to farmers.
Grandes empresas como estadounidense Chevron y ConocoPhillips, que han cultivado estrechos vínculos con el Ministerio de Petróleo iraquí y han prestado asesoramiento técnico en los últimos años, se escabuyó con las manos vacías.	Major U.S. firms such as Chevron and ConocoPhillips, which have cultivated close ties with the Iraqi Oil Ministry and have provided technical advice in recent years, walked away empty-handed.
Los tories le dijeron a Alistair Darling que "echó a perder" una oportunidad para demostrar que hablaba en serio de recortar el déficit retrasando las decisiones hasta después de las elecciones.	The Tories said Alistair Darling "blew" an opportunity to show he was serious about cutting the deficit by delaying decisions until after the election.
Los Estados Unidos no va a hacer un acuerdo sin los principales países en vías de desarrollo intensificar y tomar medidas, dijo Stern, que también se quejaba de que el texto no ha hecho lo suficiente para garantizar los recortes podrían ser verificado por fuera de observadores.	The United States is not going to do a deal without the major developing countries stepping up and taking action, said Stern, who also complained that the text did not do enough to make sure the cuts could be verified by outside observers.
Aunque no se haya completado ni una prueba de lanzamiento sin errores, el Ministerio de Defensa ruso sólo considera fallidas seis de trece pruebas realizadas.	Even though not one test launch has been completely error-free, the defence ministry consider only six out of the thirteen tests to have been failures.
Roger Bootle, asesor financiero de la auditora Deloitte	Roger Bootle, Deloitte
Bowen entrevista a los pensadores y activistas que suelen estar en desacuerdo con sus homólogos salafistas, defensores del Islam sunita purista asociado a Arabia Saudí, que hoy en día tienen una pequeña pero influyente presencia entre los musulmanes de Europa.	The thinkers and activists whom Mr Bowen interviews tend to be at odds with their Salafi counterparts—advocates of the purist Sunni Islam associated with Saudi Arabia—who nowadays have a small but influential presence among Europe’s Muslims.
Este año, los voluntarios situado más de 16.000 coronas de flores en la tumba en el cementerio de Arlington, ámbitos en el Pentágono, tumbas en Fayetteville cementerio Nacional en Arkansas, Parque pilas en la ciudad de Nueva York y en el monumento conmemorativo de United Airlines Flight 93 a Shanksville, Pa.	This year, volunteers placed more than 16,000 wreaths on the graves at Arlington Cemetery, areas at the Pentagon, graves at Fayetteville National Cemetery in Arkansas, Battery Park in New York City and on the memorial site for United Airlines Flight 93 in Shanksville, Pa.
Cellphones y ordenadores portátiles son legales en Cuba, aunque son nuevos y codiciado mercancías en un país donde el salario medio de un gobierno trabajador 15 dólares al mes.	Cellphones and laptops are legal in Cuba, though they are new and coveted commodities in a country where the average wage of a government worker is $15 a month.
No quiero decir que implican que basura no se clasifican en Brno.	I don't mean to imply that garbage isn't sorted in Brno.
En los últimos años, los directivos de Población han suavizado gradualmente su postura sobre la Política de hijo único.	In recent years, population officials have gradually softened their stance on the one-child policy.
Pistoleros filipinos retienen aún a más de 50 personas; los niños han sido liberados	Filipino gunmen still holding more than 50 people, Children have been released
La empresa trabaja en proyectos de clientes como la Agencia de los Estados Unidos para el Desarrollo Internacional y el Banco Mundial.	The company works on projects for clients such as the U.S. Agency for International Development and the World Bank.
En julio, Shanghai se convirtió en la primera ciudad china en lanzar una enérgica campaña para fomentar más nacimientos.	In July, Shanghai became the first Chinese city to launch an aggressive campaign to encourage more births.
Exxon-Mobil y Occidental Petroleum Inc. fueron las únicas empresas estadounidenses que alcanzaron acuerdos con el ministerio.	Exxon-Mobil and Occidental Petroleum Inc. were the only American companies that reached deals with the ministry.
Según uno de los espectadores, que pidió no ser identificada porque él participa en las conversaciones sobre el clima, activistas máscaras deportivos y equipos negro desencadenado varios explosivos cerca de Copenhague, que es el principal canal cercana varios ministerios.	According to one bystander, who asked not to be identified because he is involved in the climate talks, activists sporting masks and black outfits set off several explosives near Copenhagen's main canal, which is nearby several ministries.
Mi único objetivo era jugar este papel como realista posible, dijo Freeman.	My only aim was to play this role as realistically as possible, said Freeman.
Nadie debería olvidar nunca por qué somos libres... my hijo pagó por ello, dijo.	Nobody should ever forget why we're free. . .my son paid for that, she said.
Rhee dijo que el Distrito necesita seguir trajando para encontrar mejores maneras de abordar las necesidades de los estudiantes con un bajo rendimiento académico.	Rhee said the District needs to continue to find better ways to address the needs of low-achieving students.
Mientras que hace tres años él mismo criticó la idea de Bush de enviar nuevas tropas para ayudar en la asediada guerra civil en Irak como "una decisión irresponsable con consecuencias catastróficas".	While three years ago he himself criticised Bush's idea to send fresh troops to help in the beleaguered civil war in Iraq as "an irresponsible decision with catastrophic consequences".
Los contenedores de reciclaje en Brno no huelen muy bien	Recycling containers don't smell so good in Brno
El año pasado, las personas de 60 años y mayores representaron casi el 22 por ciento de los residentes censados en Shanghai, mientras que el índice de natalidad fue de menos de un hijo por pareja.	Last year, people 60 and older accounted for almost 22 percent of Shanghai's registered residents, while the birthrate was less than one child per couple.
El precio de los billetes eLiška ahora depende de la distancia recorrida, mientras que, anteriormente, fue una tarifa plana de 160 coronas para viajar por todas las ciudades de la región.	The eLiška price will now depend on the distance travelled, whereas, previously, it was a flat rate of 160 crowns to travel between any regional cities.
Los generales son optimistas sobre este casi cincuenta por ciento la tasa de éxito y seguir insistiendo en que "los Bulava" acabará volar sin problemas y que incluso llevar hasta diez bloques nuclear hypersonic pesa un total de 1,15 toneladas.	The generals are optimistic about this almost fifty-percent success rate and keep insisting that the "Bulava" will eventually fly smoothly and will even carry up to ten hypersonic nuclear blocks weighing a total of 1.15 tons.
Las instituciones políticas, no importa cuán formalmente podrían ser establecido, no será más que un vacío en el que las relaciones tribales patriarcal correrá salvajes.	Political institutions, no matter how formally they might be set up, will be nothing more than a Potemkin village in which patriarchal tribal relations will run wild.
Funeral de Margaret Thatcher	Queen, leaders to bid farewell to Thatcher
Termina el alto el fuego en Gaza	Ceasefire in Gaza underway
Glasgow vota 'sí' a la independencia de Escocia	Brexit will lead to clamour for Scottish independence, says Sturgeon
Las protestas en Hong Kong se tornan festivas tras el caos del gas lacrimógeno	Hong Kong protests escalate
El dirigente de Amanecer Dorado, en prisión preventiva pendiente de juicio	Golden Dawn leader remanded in custody
Irán y la AIEA reanudan las conversaciones nucleares	Iran, IAEA resume nuclear talks in Tehran
La generosa oferta de China a 1MDB cosecha grandes beneficios para Malasia	China keeps an eye on visiting tiger freed by Russian President
5 cosas que debes saber para tu Nuevo Día -- Viernes, 28 de Agosto	5 things to know for your New Day -- Wednesday, July 15
59 muertos en el ataque al centro comercial, asegura un ministro de Kenia	Two Indians among 39 killed in Kenya mall attack
Soldado surcoreano mata a camaradas y huye	South Korean soldier reportedly flees after killing 5 comrades at border with North Korea
Un soldado de la OTAN falleció en un ataque talibán en Afganistán	NATO soldier killed in Afghan attack
Cameron pide más acción en relación a la crisis de los inmigrantes después del caos en Calais	Camerwoman fired for tripping up fleeing migrants
Los buceadores recuperan cuerpos del ferri hundido; el número de víctimas supera las 50	South Korea sunken ferry death toll 'reaches 50'
Obama concluirá su visita histórica a Kenia dirigiéndose a la nación	Obama to close historic Kenya visit with national address
territorio palestino ocupado: las fuerzas israelíes matan a un covi palestino y hieren a otro al sur de Nablus	occupied Palestinian territory: IOF Arrest Two Minors on Gaza Border and Abuse One of Them
Más de 60 fallecidos en un funeral iraquí	At least 18 killed in Iraq mosque bombing
Muere el actor británico Bob Hoskins a los 71 años	Actor Bob Hoskins Dead at 71
Estados Unidos presiona a Irak sobre los informes de los acuerdos de armas con Irán	US presses Iraq on reports of arms deal with Iran
El jefe del Cartel de Sinaloa capturado en Méjico	Mexico's Sinaloa drug chief arrested
Obama: la amenaza del ébola hacia «la Seguridad Regional y Global»	Obama: Ebola outbreak also a security threat
Menéndez se enfrenta a posible cargos por corrupción	Benzema faces possible charges in sex-tape case
El bautizo del príncipe Jorge de Cambridge está en curso	Prince George christened by archbishop in London
Las fuerzas iraquíes terminan con el asedio militar de la ciudad Shia	Iraqi forces retake 2 military bases in Anbar
La policía de Baltimore aplica la tercera noche con toque de queda	Metro police to get fresh training in crowd handling at police academy
Los tramposos de Ashley Madison al descubierto	Ashley Madison users facing extortion threats
Las acciones mundiales aumentan esperanzas en Fed para mantener el estímulo	Fed expected to maintain stimulus
La bolsa china se abrirá con mayores valores el lunes	Chinese shares close lower Thursday
El hermano de Dana, John Brown, absuelto de dos cargos por abuso sexual	Court clears Dana's brother of all counts of historic sex abuse
Se estiman mil muertos tras un tifón que arrasa Filipinas	Over 100 Dead as Typhoon Slams Central Philippines
Los expertos afirman que los precios mínimos del alcohol "salvarán 860 vidas al año"	Minimum alcohol pricing would save 860 lives a year, study finds
Iran es optimista acerca de la posibilidad de alcanzar un acuerdo nuclear, EE UU bastante menos	Historic nuclear deal reached; Iran no longer under sanction
Hosni Mubarak será liberado en el plazo de unos días, según su abogado	Egypt's Mubarak to be freed from jail, lawyer says
La bolsa de Singapur abre el jueves con una subida del 0,19%	Singapore shares open 0.28% lower on Thursday
Irán está listo para retomar las exportaciones de petróleo a Egipto	Global pressure on US to loosen oil exports ban
Las Maldivas empiezan a votar en las polémicas elecciones presidenciales	Crisis-hit Maldives holds new presidential poll
Las fuerzas israelís detienen a 2 palestinos durante  las redadas de arresto nocturnas.	Israeli forces detain Palestinian MP in Hebron
La ONU votará acerca de la resolución MH17	UN vote on Aust MH17 resolution
Se abren las encuestas sobre la última vuelta de las elecciones presidenciales de Afganistán	Afghanistan begins run-off votes for Presidential election
Los clubs de la Premier League fuera para evitar los problemas de la Champions League	Gunners fire but fail to advance in Champions League
Obama comienza su viaje por África en Senegal	Obama begins Africa tour in Senegal
Ciudadano somalí arrestado tras un intento de violación	Bali arrest over attempted schoolie rape
El Tesoro propone un incremento del impuesto sobre la renta del 1,5% en el presupuesto	Treasury proposal sees 1.5% increase in income tax
Aviones al borde del accidente en el aeropuerto de Vietnam	Two planes nearly collide at central Vietnam airport
Cinco muertos en un tiroteo en Arabia Saudí	3 killed, 4 injured in Los Angeles shootings
Un terremoto de magnitud 4,1 sacude el sudoeste de China	Strong 6.0-magnitude quake hits northern California
Los sondeos de votos malayos para la estabilidad o el cambio	Malaysia elections: Malaysians vote with power at stake for first time
El príncipe Guillermo realiza un llamamiento a la FIFA	Prince William begins Japan tour
Cientos de soldados Iraníes se concentran en Siria	Hundreds of Ukranian troops retreat across border to Russia
3 heridos durante el ataque lanzado por hombres armados en Kabul	Gunmen Attack Shi'ite Mosque In Kabul
Por qué Mitch McConnell no está tan condenado al fracaso como esta encuesta te podría hacer creer	Mitch McConnell tied in new poll. Does he miss Ashley Judd yet?
La retirada de armamento pesado, en punto muerto en el este de Ucrania	Rebel weaponry cut back in eastern Ukraine
El ladrón de Cannes robó joyas de la exposición Leviev del hotel	Cannes' second jewellery heist in months
Los egipcios dicen «sí» a la nueva constitución	Egypt regime hails passage of new constituion
Más de 2000 inmigrantes rescatados de barcos de madera en el Mediterráneo	More than 3,400 migrants rescued at sea in Mediterranean
