La enmienda n.º 7 propone ciertos cambios en las referencias a los párrafos.	Amendment 7 changes in references to paragraphs.
have a great affection, liking, or desire for	sentir un gran afecto o simpatía por.
el extremo positivo de la batería y el terminal 1 no están conectados	Terminal 1 and the positive terminal are not connected
Russia finds dead lawyer Magnitsky guilty in posthumous trial	Rusia declara culpable al abogado Magnitsky en juicio póstumo
11 killed in Chinese police station attack	Once muertos en ataque a una comisaría en China
A black dog with a blue collar is running in the snow.	Un perro negro con un collar azul está corriendo en la nieve.
Value measured by what must be given or done to obtain something.	valor medido por lo que debe darse o hacerse o sufrirse para obtener algo.
Un hombre está tocando la batería.	A man plays the drum.
Las bombillas A y C todavía estaban contenidas en circuitos cerrados con la batería	Bulbs A and C are still contained in closed paths with the battery
Tren en una estación.	a train in a station.
Hurricane Sandy Closes in on US East Coast	El huracán Sandy amenaza la costa este de Estados Unidos
the blub is not contained in the same closed path as the battery	La bombilla no está en el circuito cerrado que contiene la batería
Es más, las divisiones se reproducen a nivel local.	Beyond the geographical division, the divisions occur at local level.
Esa disposición podría abrir las puertas de la arbitrariedad.	This point of the rules of procedure opens the door to the arbitrary.
That is the spirit in which the European Constitution must be written.	Ese es el espíritu con el que debe resolverse la Constitución Europea.
The man is riding a horse.	Un hombre está cabalgando.
A man and a dog on rocks on a beach.	Un hombre y un perro en una costa rocosa.
The fishermen are inactive, tired and disappointed.	Los pescadores están desempleados, cansados y decepcionados.
Las fuerzas israelíes detienen a cinco palestinos en Cisjordania	Israeli Forces Arrest Five Palestinians across West Bank
The man is playing the guitar.	Un hombre está tocando la guitarra.
Esa disposición podría abrir las puertas de la arbitrariedad.	This point of the payment opens the door with the arbitrary one.
Es más, las divisiones se reproducen a nivel local.	Beyond the geographical division, divisions recur locally.
El hombre agujereó la madera.	A man drills wood.
Man standing in front of silver train.	Hombre parado frente a un vagón plateado.
A woman with a white horse.	Una mujer que dirige a un caballo blanco.
Massive Hurricane Sandy bears down on U.S. East Coast	El huracán Sandy amenaza la costa este de Estados Unidos
In the last three weeks, progress has been made in three major areas.	En las últimas semanas, se ha conseguido tres progresos importantes. 
Dozens die as clashes erupt at Morsi rally in Cairo	Más de 70 muertos por enfrentamientos ocurridos en concentraciones de apoyo a Morsi en Egipto
¿El ministro Clarence Thomas rompe el silencio en un artículo de The New York Times o the Onion? No está claro.	Justice Thomas Breaks His Silence in Court
Una oveja sobre una mesa en una subasta.	Woolly sheep at auction house.
a problem, something wrong	un problema.
Someone is playing piano.	Una persona está tocando el piano eléctrico.
Una mujer está cortando un huevo duro.	A person is cutting a boiled egg into pieces.
Un hombre está tocando la guitarra.	A man is singing while playing the guitar.
Un perro negro mojado con un collar rojo está en el río	A black dog with a red collar wading through the water.
Tren en una estación.	Trains inside an indoor station.
Iran will attack Tel Aviv if Israel strikes	Clérigo superior: Irán atacará Tel Aviv si Israel ataca
reaccionar, o responder a una llamada, orden o estímulo	react to a stimulus or command.
Un tren Amtrak de pasajeros espera en una estación.	A passenger train waiting in a station.
Are all on separate paths	A y C están en circuitos distintos
because bulb c is not included in the closed path	Hay un circuito cerrado con A y B en el que no está C.
Un hombre está tocando la guitarra.	A woman is playing the guitar.
Dolce and Gabbana convicted of tax evasion	Dolce & Gabbana recibe una multa en una causa tributaria en Italia
pasar la lengua, levantar con la lengua	pass the tongue over.
The bird is sitting on the branch.	Un pájaro rojo y marrón está posado en una rama.
A horse rider is riding a white horse.	Una mujer que dirige a un caballo blanco.
reach a destination or goal	llegar a un destino; llegar por movimiento o progreso.
A pug dog wits on a yellow chair next to a green dumpster.	Un bulldog sentado en una silla amarilla al lado de un contenedor grande de basura.
Motor Racing: Button fastest in year's first F1 practice	Botón con el mejor tiempo después de la primera práctica
Una mujer hierve huevos.	A woman places two eggs into a pot of water.
the bulb is not contained in the path	La bombilla no está en el circuito cerrado que contiene la batería
Ha muerto el hombre que se inmoló en llamas en National Mall	Man Sets Himself on Fire on National Mall, Flown to Hospital
Israel inicia el ataque aéreo en la Franja de Gaza	Israel launches air strikes near Damascus
A young blonde girl wearing a helmet sits with a red bicycle behind her.	Una niña que lleva puesto un casco con una bicicleta de fondo.
A white animal running through snow covered woods.	Un perro blanco corre a través de un bosque nevado.
Un hombre está cabalgando.	A girl is riding a horse.
Bulb A, bulb B and bulb C are in different closed paths.	A y C están en circuitos distintos
Music Industry Pays Tribute to Whitney Houston	La industria de la música llora a Whitney Houston
Un muchacho montado en un caballo blanco.	A man riding a white horse in an arena.
You can find where there is a gap.	La medición del voltaje indica si entre dos terminales hay una separación.
bulb C and A are contained in the same path with the battery	A y C están en circuitos distintos
A man is playing the guitar.	Un hombre está tocando la batería.
European markets rise on Greek bailout hopes	Los ministros europeos se preparan para aprobar el rescate de Grecia
Un hombre está cabalgando.	A woman is riding an elephant.
A man is playing a flute in a band.	Un hombre está tocando la guitarra.
Bangkok tense on Thai election eve	Bangladés: Aumenta la ofensiva de cara a las elecciones
I don't know if this goes for people generally, but that was how it went.	Sé que les molesta a ustedes los socialistas o progresistas, pero así es como son las cosas.
A white cat standing on a carpet.	Un bonito gato de rayas blancas con la cabeza colgando del borde de la mesa.
A man riding a white horse.	Una mujer que dirige a un caballo blanco.
Turkmenistan borders Afghanistan.	Sistán y Baluchistán tiene frontera con Afganistán y Pakistán.
A small red and gray bird perched amongst the bare branches of a tree.	Un pájaro rojo y marrón está posado en una rama.
Bush gets zero credit for the budget under him.	Y Obama no recibe ningún crédito para el presupuesto oficial.
Doce muertos en atentado de bomba en tren pakistaní	Five killed by bomb blast in East India
Hombre detenido por un doble asesinato	WA man arrested in police drug raid
Nato airstrike kills two Afghan kids	Soldado de la OTAN muere en Afganistán
A little girl in a red shirt pulls a kite.	Una niña que viste una camiseta roja toma una fotografía con un teléfono.
Un hombre está tocando la guitarra.	A man is driving a car.
all the bulbs are on parralel paths	A y C están en circuitos distintos
MIER ups 2012 growth forecast to 4.2pc	CMIE reduce a un 6,3 % las previsiones de crecimiento para el periodo de 2012-2013
Un hombre está cabalgando.	A man is talking on a phone.
the act of concealing or disguising	la acción de salir de algo.
A white dog with red ears is running in the snow.	un perro negro mojado con un collar rojo está en el río
Terremoto de magnitud 4,1 sacude a los Estados Unidos	7.2 magnitude earthquake strikes Philippines
Decenas de muertos en disturbios en Nigeria	Dozens killed in Kenyan clashes
Siete muertos en tiroteo en una escuela cristiana	5 wounded in Ohio school shooting
Una persona está revolviendo el arroz.	A woman is cracking an egg.
(La acción de hacer) una medida de algo.	the act of making up your mind about something.
A man is opening a box using a knife.	Un hombre está tocando la guitarra.
A man is kicking oots of water.	Una mujer está cortando un pimiento rojo.
la raíz de una palabra	the removal of an opponent's piece from the chess board.
Un hombre está tocando la batería.	A woman is slicing some leaves.
Una niña que lleva puesto un casco con una bicicleta de fondo.	A women holds a small dog on a leash with chairs in the background.
Una mujer está pelando los camarones.	A man is dancing in rain.
Todos los ojos están puestos en Raheel Sharif, el nuevo jefe del ejército pakistaní	Flood alerts in France as river levels rise
Create a coating for something.	la acción de salir de algo.
Un niño vestido de rojo saltando a un arenero.	A dog swimming in a pond
medir el tiempo o la duración de	make weak by stunting the growth or development of.
Obama jamás pronunció la palabra "amenaza" o "amenazar". 	they found the bomb before they found the woman.
A woman is slicing meat with a knife.	Un hombre está estirando la masa.
una persona que es miembro de la cámara de senadores	a person who is a member of a partnership.
the act of confining, preventing or blocking something	La acción de referirse o consultar.
(La acción de tomar) una medida de algo.	the act of removing or getting rid of something.
Una vaca está comiendo hierba.	A dog is pulling a girl down a hill.
